%%%%%%%%%%%%%
%.  oooo%  .%
% % oooo  % %
%P         .%
%%%%%%%%%%%%%