%%%%%%%
%  B A%
% %%% %
%  %  %
%%   %%
%ab%%%%
%%%%%%%