%%%%%%%%%%%%%%%%%%%%%%
%.%%        % %     .%
%    %%%%%% % %%%%%% %
%%%%%%     P  %      %
%    % %%%%%% %% %%%%%
% %%%% %         %   %
%        %%% %%%   % %
%%%%%%%%%%    %%%%%% %
%.         %%       .%
%%%%%%%%%%%%%%%%%%%%%%